11111111111
10000010001
10100010101
O0100000101
10111110101
10101000101
10001010001
11111010001
101I1010001
10000010001
11111111111
