111111
111001
1000O1
100I11
111111
