1111111
1O00001
1110111
1000001
100I001
1111111
